R 1920 1080

NO ./assets/textures/NO.xpm
SO ./assets/textures/SO.xpm
WE ./assets/textures/WE.xpm
EA ./assets/textures/EA.xpm

S ./assets/textures/ITEM.xpm
F 255,255,255
C 255,255,255

        1111111111111111111111111
        1000000000110000000000001
        1011000001110000001000001
        1001000000000000000000001
111111111011000001110000000000001
100000000011000001110111110111111
11110111111111011100000010001
11110111111111011101010010001
11000000110101011100000010001
10000000010000001100000010001
10000000001000001101010010001
1100000000010101111101111000111
111100N000001101 101111010001
1111111111111111 111111111111
